***********************
*                     *
*                     *
*  *                  *
*   *                 *
*    *                *
*     *               *
*      *              *
*       *             *
*        *            *
*         *           *
*          *          *
*           *         *
*            *        *
*             *       *
*              *      *
*               *     *
*                *    *
*                 *   *
*                  *  *
*                     *
*                     *
***********************
